PASSWORD:program.08
WIDTH:10
HEIGHT:10
POLE:
GGGGGGGGGG
G1111111GG
G2GGGGG2GG
G2GG1111GG
G2GG2GGGGG
G2GG2GGGGG
G2GG2GGGGG
G2GG2GGGGG
G2GG2GGGGG
G2GG111111