PASSWORD:program.08
WIDTH:10
HEIGHT:10
POLE:
GGGGGGGGGG
G3111114GG
G2GGGGG2GG
G2GG3115GG
G2GG2GGGGG
G2GG2GGGGG
G2GG2GGGGG
G2GG2GGGGG
G2GG2GGGGG
G2GG611111