PASSWORD:program.08
WIDTH:10
HEIGHT:10
POLE:
GGGGGGGGGG
GIIIIIIIGG
GIGGGGGIGG
GIGGIIIIGG
GIGGIGGGGG
GIGGIGGGGG
GIGGIGGGGG
GIGGIGGGGG
GIGGIGGGGG
GIGGIIIIII